                                                                                                    |
                                      444                                       222                 |
                                     4   4                     333            2    2 2 2            |
                            3 2 3         4                   4              2   Q--Q--Q--Q--       |
                   4  4  4 Q--Q--Q--       4                 3     3       2                        |
         33333    Q--Q--Q--              2223333333333              2 2 2                           |
        Q -Q--Q-         2222222222222222    4           Q--Q--Q--Q--111Q--Q--222Q--Q--   Q--Q--Q--Q|
                        1         XYZ          1111111111                                           |
P-P-P-P-P-P-P-P-P-P-P-P-P-P-P-P-P-P-P-P-P-P-P-P-P-P-P-P-P-P-P-P-P-P-P-P-P-P-P-P-P-P-P-P-P-P-P-P-P-P-|
----------------------------------------------------------------------------------------------------|
                                                                                                    |
                                                                                                    |
                     Q--                                                                            |
                  Q--         Q--                       Q--     Q--                                 |
               Q--                            Q--                         Q--                       |
            Q--                        Q--                                      Q--Q--Q--Q--Q--Q--  |
         Q--                                                                                        |
                                                                                                    |
P-P-P-P-P-P-P-P-P-P-P-P-----------------------------------------------------------------------------|
----------------------------------------------------------------------------------------------------|
                                                                                                    |
                                                                                                    |
  1232112                                                                                           |
   Q--Q--Q--Q--             Q--Q--Q--Q--               Q--Q--Q--Q--          Q--Q--Q--Q--           |
                                                           22222222321312312321312            21212 |
12322        12                              1111111111111                    3123123134231231      |
--    Q--Q--Q--Q--     Q--Q--Q--Q--        Q--Q--Q--Q--      Q--Q--Q--Q--      Q--Q--Q--Q--         |
                   1232                                                                             |
P-P-P-P-P-P-P-P-P-P-P-P-P-P-P-P-P-P-P-P-P-P-P-P-P-P-P-P-P-P-P-P-P-P-P-P-P-P-P-P-P-P-P-P-P-P-P-P-P-P-|
----------------------------------------------------------------------------------------------------|
                                                                                                    |
                                                                                                    |
                                                                              4 4                   |
                        2     3 3 3                3 3 3                3 3 3      3 3              |
                       1 2                          2 2                       3 3 3                 |
1 1 1 1 1 1   2 2 2   1   2 2        2 2   3   2 2       2 2   3    2 2                2 2 2   2 2 2|
     3 333333333333        2                                                                        |
1 1 1 1 1 1 1       1 1 1   1            1 1 1               1 1 1                            1 1 1 |
P-P-P-P-P-P-P-P-P-P-P-P-P-P-P-P-P-P-P-P-P-P-P-P-P-P-P-P-P-P-P-P-P-P-P-P-P-P-P-P-P-P-P-P-P-P-P-P-P-P-|
----------------------------------------------------------------------------------------------------|
                                                                                                    |
                                                                                                    |
                                                        4 4                                         |
                     3 3 3                       3 3 3      3 3                                     |
                                 3 3 3                  3 3                                         |
   2 2 2         2 2       2 2               2 2                 2 2 2           2 2                |
                                                                                        22314242145 |
1         1 1 1                  1 1 1 1 1 1                            1 1 1 1       1 1 1 1 1 1 1 |
P-P-P-P-P-P-P-P-P-P-P-P-P-P-P-P-P-P-P-P-P-P-P-P-P-P-P-P-P-P-P-P-P-P-P-P-P-P-P-P-P-P-P-P-P-P-P-P-P-P-|
----------------------------------------------------------------------------------------------------|
                                                                                                    |
                                                                                                    |
                                                                              4 4                   |
                              3 3 3                3 3 3                3 3 3      3 3              |
                                                                                                    |
              2 2 2       2 2        2 2       2 2       2 2        2 2                2 2 2        |
                                                                                                    |
1 1 1 1 1 1 1       1 1 1                1 1 1               1 1 1                            1 1 1 |
P-P-P-P-P-P-P-P-P-P-P-P-P-P-P-P-P-P-P-P-P-P-P-P-P-P-P-P-P-P-P-P-P-P-P-P-P-P-P-P-P-P-P-P-P-P-P-P-P-P-|
----------------------------------------------------------------------------------------------------|
                                                                                                    |
                                                                                                    |
                                                        4 4                                         |
                     3 3 3                       3 3 3      3 3                                     |
                                                                                                    |
   2 2 2         2 2       2 2               2 2                 2 2 2           2 2                |
                                                                                                    |
1         1 1 1                  1 1 1 1 1 1                            1 1 1 1       1 1 1 1 1 1 1 |
P-P-P-P-P-P-P-P-P-P-P-----P-P-P-P-P-P-P-P-P-P-P-P-P-P-P-P-P-P-P-P-P-P-P-P-P-P-P-P-P-P-P-P-P-P-P-P-P-|
----------------------------------------------------------------------------------------------------|
                                                                                                    |
                                                                                                    |
                                                                                                    |
                                                                                                    |
                                                                                                    |
                               22                                     3 3                           |
            1 1 1 1 1         2  2     2 2         2 2     2       2 2                              |
    11111111 1 1 1 1 111111111    11111            1 1 1 1           1 1 1                          |
P-P-P-P-P-P-P-P-P-P-P-P-P-P-P-P-P-P-P-P-P-P-P-P-P-P-P-P-P-P-P-P-P-P-P-P-P-P-P-P-P-P-P-P-P-P-P-P-P-P-|
----------------------------------------------------------------------------------------------------|
                                                                                                    |
                                                                                                    |
                                                                                                    |
                                                                                                    |
                                                                          4 4                       |
                                3 3 3                 3 3             3 3                           |
                  2 2 2       2       2 2         2 2     2       2 2                               |
    1 1 1 1 1 1 1       1 1 1             1 1 1 1           1 1 1                                   |
P-P-P-P-P-P-P-P-P-P-P-P-P-P-P-P-P-----P-P-P-P-P-P-P-P-P-P-P-P-P-P-P-P-P-P-P-P-P-P-P-P-P-P-P-P-P-P-P-|
----------------------------------------------------------------------------------------------------|
                                                                                                    |
                                                         1 1                                        |
      x                                                1     1                                      |
                                         Q--Q--Q--Q--1         1               333                  |
 O---------         22222              2 2 2 2 2 2 2             2 2 2 2 2 2 232 23                 |
                1111     1 1 1 1 1 1 1       Q--Q--Q--Q--                    3     3 1 1 1 1        |
                  O---------             1 1 1 1 1 1 1 1 1 1 1 1 1 1 1      3       3        4 4 4 4|
   1 2 3 4 1 2 3 4 1 1 1 1 1 1 1 1 1 1 1                 ---             1 1         311            |
P-P-P-P-P-P-P-P-P-P-P-P-P-P-P-P-P-P-P-P-P-P-P-P-P-P-P-P-P-P-P-P-P-P-P-P-P-P-P-P-----P-P-P-P-P-P-P-P-|
----------------------------------------------------------------------------------------------------|
                                                                                                    |
                                                         1 1                                        |
      x                                                1     1                                      |
                                         Q--Q--Q--Q--1         1               333                  |
 O---------         22222              2 2 2 2 2 2 2             2 2 2 2 2 2 232 23                 |
                1111     1 1 1 1 1 1 1       Q--Q--Q--Q--                    3     3 1 1 1 1        |
                  O---------             1 1 1 1 1 1 1 1 1 1 1 1 1 1 1      3       3        4 4 4 4|
   1 2 3 4 1 2 3 4 1 1 1 1 1 1 1 1 1 1 1                 ---             1 1         311            |
P-P-P-P-P-P-P-P-P-P-P-P-P-P-P-P-P-P-P-P-P-P-P-P-P-P-P-P-P-P-P-P-P-P-P-P-P-P-P-P-P-P-P-P-P-P-P-P-P-P-|
----------------------------------------------------------------------------------------------------|
                                                                                                    |
                                                                                                    |
                                                           1 1 1 1 1 1 1 1 1                        |
                                            1 1 1 1 1 1 1 1                   1 1 1 1 1             |
                             2 2 2 2 2 2 2                                             2 2 2 2 2    |
               1 1 1 1 1 1 1                                                                        |
 4 4 4 4 4 4 4                                                                                      |
                                                                                                    |
P-P-P-P-P-P-P-P-P-P-P-P-P-P-P-P-P-P-P-P-P-P-P-P-P-P-P-P-P-P-P-P-P-P-P-P-P-P-P-P-P-P-P-P-P-P-P-P-P-P-|
----------------------------------------------------------------------------------------------------|
                                                                                                    |
                                                         1 1                                        |
                                                       1     1                                      |
                                                     1         1                                    |
                    33333              2 2 2 3 3 3 3             3 3 3 3 3 3 3 3 3                  |
                1111     1 1 1 1 1 1 1                    -                        1 1 1 1 1        |
                                                         -x-                                 1 1 1 1|
                                                         ---                                        |
P-P-P-P-P-P-P-P-P-P-P-P-P-P-P-P-P-P-P-P-P-P-P-P-P-P-P-P-P-P-P-P-P-P-P-P-P-P-P-P-P-P-P-P-P-P-P-P-P-P-|
----------------------------------------------------------------------------------------------------|
                                                                                                    |
                                                                                                    |
                                                           4 4 4 4 4 4 4 4 4                        |
                                           1 1 1 1 1 1 1 1                   1 1 1 1 1              |
                             3 3 3 3 3 3 3                                             3 3 3 3 3    |
               1 1 1 1 1 1 1                                                                        |
 1 1 1 1 1 1 1                                                                                      |
                                                                                                    |
P-P-P-P-P-P-P-P-P-P-P-P-P-P-P-P-P-P-P-P-P-P-P-P-P-P-P-P-P-P-P-P-P-P-P-P-P-P-P-P-P-P-P-P-P-P-P-P-P-P-|
----------------------------------------------------------------------------------------------------|
                                                                                                    |
                                                         1 1                                        |
                                                       1     1                                      |
                                                     1         1                                    |
                    11111              1 1 1 1 1 1 1             1 1 1 1 1 1 1 1 1                  |
                1111     1 1 1 1 1 1 1                    -                        1 1 1 1 1        |
                                                         -x-                                 1 1 1 1|
                                                         ---                                        |
P-P-P-P-P-P-P-P-P-P-P-P-P-P-P-P-P-P-P-P-P-P-P-P-P-P-P-P-P-P-P-P-P-P-P-P-P-P-P-P-P-P-P-P-P-P-P-P-P-P-|
----------------------------------------------------------------------------------------------------|
                                                                                                    |
                                                                                                    |
                                                           1 1 1 1 1 1 1 1 1                        |
                                           1 1 1 1 1 1 1 1                   1 1 1 1 1              |
                             1 1 1 1 1 1 1                                             1 1 1 1 1    |
               1 1 1 1 1 1 1                                                                        |
 1 1 1 1 1 1 1                                                                                      |
                                                                                                    |
P-P-P-P-P-P-P-P-P-P-P-P-P-P-P-P-P-P-P-P-P-P-P-P-P-P-P-P-P-P-P-P-P-P-P-P-P-P-P-P-P-P-P-P-P-P-P-P-P-P-|
----------------------------------------------------------------------------------------------------|

[Finished in 0.1s]